    00000000000000000000000000000000000000000000000000000000000000000000000000000000000000000000000000001111111111111111111111111111
    00000000001111111111222222222233333333334444444444555555555566666666667777777777888888888899999999990000000000111111111122222222
    01234567890123456789012345678901234567890123456789012345678901234567890123456789012345678901234567890123456789012345678901234567    

    00000000000000001111111111111111222222222222222233333333333333334444444444444444555555555555555566666666666666667777777777777777
    0123456789ABCDEF0123456789ABCDEF0123456789ABCDEF0123456789ABCDEF0123456789ABCDEF0123456789ABCDEF0123456789ABCDEF0123456789ABCDEF
-----------------------------------------------------------------------------------------------------------------------------------
000|22222222222222222222222222222222222222222222222222222222222222222222222222222222222222222222222222222222222222222222222222222222
001|22222222222222222222222222222222222222222222222222222222222222222222222222222222222222222222222222222222222222222222222222222222
002|22222222222222222222222222222222222222222222222222222222222222222222222222222222222222222222222222222222222222222222222222222222
003|22222222222222222222222222222222222222222222222222222222222222222222222222222222222222222222222222222222222222222222222222222222
004|22000000000000000000000000000000000000000000000000000000000000000000000000000000000000000000000000000000000000000000000000000022
005|22000000000000000000000000000000000000000000000000000000000000000000000000000000000000000000000000000000000000000000000000000022
006|22000000000000000000000000000000000000000000000000000000000000000000000000000000000000000000000000000000000000000000000000000022
007|22000000000000000000000000000000000000000000000000000000000000000000000000000000000000000000000000000000000000000000000000000022
008|22000000000000000000000000000000000000000000000000000000000000000000000000000000000000000000000000000000000000000000000000000022
009|22000000000000000000000000000000000000000000000000000000000000000000000000000000000000000000000000000000000000000000000000000022
00A|22000000000000000000000000000000000000000000000000000000000000000000000000000000000000000000000000000000000000000000000000000022
00B|22000000000000000000000000000000000000000000000000000000000000000000000000000000000000000000000000000000000000000000000000000022
00C|22000000000000000000000000000000000000000000000000000000000000000000000000000000000000000000000000000000000000000000000000000022
00D|22000000000000000000000000000000000000000000000000000000000000000000000000000000000000000000000000000000000000000000000000000022
00E|22000000000000000000000000000000000000000000000000000000000000000000000000000000000000000000000000000000000000000000000000000022
00F|22000000000000000000000000000000000000000000000000000000000000000000000000000000000000000000000000000000000000000000000000000022
010|22000000000000000000000000000000000000000000000000000000000000000000000000000000000000000000000000000000000000000000000000000022
011|22000000000000000000000000000000000000000000000000000000000000000000000000000000000000000000000000000000000000000000000000000022
012|22000000000000000000000000000000000000000000000000000000000000000000000000000000000000000000000000000000000000000000000000000022
013|22000000000000000000000000000000000000000000000000000000000000000000000000000000000000000000000000000000000000000000000000000022
014|22000000000000000000000000000000000000000000000000000000000000000000000000000000000000000000000000000000000000000000000000000022
015|22000000000000000000000000000000000000000000000000000000000000000000000000000000000000000000000000000000000000000000000000000022
016|22000000000000000000000000000000000000000000000000000000000000000000000000000000000000000000000000000000000000000000000000000022
017|22000000000000000000000000000000000000000000000000000000000000000000000000000000000000000000000000000000000000000000000000000022
018|22000000000000000000000000000000000000000000000000000000000000000000000000000000000000000000000000000000000000000000000000000022
019|22000000000000000000000000000000000000000000000000000000000000000000000000000000000000000000000000000000000000000000000000000022
01A|22000000000000000000000000000000000000000000000000000000000000000000000000000000000000000000000000000000000000000000000000000022
01B|22000000000000000000000000000000000000000000000000000000000000000000000000000000000000000000000000000000000000000000000000000022
01C|22000000000000000000000000000000000000000000000000000000000000000000000000000000000000000000000000000000000000000000000000000022
01D|22000000000000000000000000000000000000000000000000000000000000000000000000000000000000000000000000000000000000000000000000000022
01E|22000000000000000000000000000000000000000000000000000000000000000000000000000000000000000000000000000000000000000000000000000022
01F|22000000000000000000000000000000000000000000000000000000000000000000000000000000000000000000000000000000000000000000000000000022
020|22000000000000000000000000000000000000000000000000000000000000000000000000000000000000000000000000000000000000000000000000000022
021|22000000000000000000000000000000000000000000000000000000000000000000000000000000000000000000000000000000000000000000000000000022
022|22000000000000000000000000000000000000000000000000000000000000000000000000000000000000000000000000000000000000000000000000000022
023|22000000000000000000000000000000000000000000000000000000000000000000000000000000000000000000000000000000000000000000000000000022
024|22000000000000000000000000000000000000000000000000000000000000000000000000000000000000000000000000000000000000000000000000000022
025|22000000000000000000000000000000000000000000000000000000000000000000000000000000000000000000000000000000000000000000000000000022
026|22000000000000000000000000000000000000000000000000000000000000000000000000000000000000000000000000000000000000000000000000000022
027|22000000000000000000000000000000000000000000000000000000000000000000000000000000000000000000000000000000000000000000000000000022
028|22000000000000000000000000000000000000000000000000000000000000000000000000000000000000000000000000000000000000000000000000000022
029|22000000000000000000000000000000000000000000000000000000000000000000000000000000000000000000000000000000000000000000000000000022
02A|22000000000000000000000000000000000000000000000000000000000000000000000000000000000000000000000000000000000000000000000000000022
02B|22000000000000000000000000000000000000000000000000000000000000000000000000000000000000000000000000000000000000000000000000000022
02C|22000000000000000000000000000000000000000000000000000000000000000000000000000000000000000000000000000000000000000000000000000022
02D|22000000000000000000000000000000000000000000000000000000000000000000000000000000000000000000000000000000000000000000000000000022
02E|22000000000000000000000000000000000000000000000000000000000000000000000000000000000000000000000000000000000000000000000000000022
02F|22000000000000000000000000000000000000000000000000000000000000000000000000000000000000000000000000000000000000000000000000000022
030|22000000000000000000000000000000000000000000000000000000000000000000000000000000000000000000000000000000000000000000000000000022
031|22000000000000000000000000000000000000000000000000000000000000000000000000000000000000000000000000000000000000000000000000000022
032|22000000000000000000000000000000000000000000000000000000000000000000000000000000000000000000000000000000000000000000000000000022
033|22000000000000000000000000000000000000000000000000000000000000000000000000000000000000000000000000000000000000000000000000000022
034|22000000000000000000000000000000000000000000000000000000000000000000000000000000000000000000000000000000000000000000000000000022
035|22000000000000000000000000000000000000000000000000000000000000000000000000000000000000000000000000000000000000000000000000000022
036|22000000000000000000000000000000000000000000000000000000000000000000000000000000000000000000000000000000000000000000000000000022
037|22000000000000000000000000000000000000000000000000000000000000000000000000000000000000000000000000000000000000000000000000000022
038|22000000000000000000000000000000000000000000000000000000000000000000000000000000000000000000000000000000000000000000000000000022
039|22000000000000000000000000000000000000000000000000000000000000000000000000000000000000000000000000000000000000000000000000000022
03A|22000000000000000000000000000000000000000000000000000000000000000000000000000000000000000000000000000000000000000000000000000022
03B|22000000000000000000000000000000000000000000000000000000000000000000000000000000000000000000000000000000000000000000000000000022
03C|22000000000000000000000000000000000000000000000000000000000000000000000000000000000000000000000000000000000000000000000000000022
03D|22000000000000000000000000000000000000000000000000000000000000000000000000000000000000000000000000000000000000000000000000000022
03E|22000000000000000000000000000000000000000000000000000000000200000000000000000000000000000000000000000000000000000000000000000022
03F|22000000000000000000000000000000000000000000000000000000000200000000000000000000000000000000000000000000000000000000000000000022
040|22000000000000000000000000000000000000000000000000000000000200001111111111000000000000000000000000000000000000000000000000000022
041|22000000000000000000000000000000000000000000000000000000000200000000000000100000022200000000000000000000000000000000000000000022
042|22000000000000000000000000000000022222222222222222222222222200000000000000010000002220000000000000000000000000000000000000000022
043|22000000000000000000000000000000022222220000000000000000000022222222222222001000000222000000000000000000000000000000000000000022
044|22000000000000000000000000000000022222220000000000000000000200000000000000000100000022200000000000000000000000000000000000000022
045|22000000000000000000000000000000022222220000000001111111111200000000000000000010000002220000000000000000000000000000000000000022
046|22000000000000000000000000000000022222220000000010000000000200000000000000000001000000222000000000000000000000000000000000000022
047|22000000000000000000000000000000022222200000000100000000000200000000000000000000100000022200000000000000000000000000000000000022
048|22000000000000000000000000000000022222200000001000000000000200000000000000000000010000002220000000000000000000000000000000000022
049|22000000000000000000000000000000022220000000010000000000000000000000000000000000001000000022200000000000000000000000000000000022
04A|22000000000000000000000000000000022000000000100000000000000000000000000000000000000100000002220000000000000000000000000000000022
04B|22000000000000000000000000000000022000000001000000000000000000000000000000000000000100000002220000000000000000000000000000000022
04C|22000000000000000000000000000000000000000010000000000000000000000000000000000000000100000002220000000000000000000000000000000022
04D|22000000000000000000000000000000000000020010000000000000000000000000000000000000000100000002220000000000000000000000000000000022
04E|22000000000000000000000000000000000000020010000000000000222222222222222222222222000100000002220000000000000000000000000000000022
04F|22000000000000000000000000000000000000020010000000000000222000000000000000000000000100000002220000000000000000000000000000000022
050|22000000000000000000000000000000000000020010000000000000222000000000000000000000000100000002220000000000000000000000000000000022
051|22000000000000000000000000000000000000020010000000000000222000011111111111000000000100000002220000000000000000000000000000000022
052|22000000000000000000000000000000000000020010000000000000222000010000000001000000000100000002220000000000000000000000000000000022
053|22000000000000000000000000000000000000020010000000000000222000010000000001000000000100000002220000000000000000000000000000000022
054|22000000000000000000000000000000000000020010000222222222222000010000000001000000000100000002220000000000000000000000000000000022
055|22000000000000000000000000000000002222220010000222222222222000011111111111111111111100000000000000000000000000000000000000000022
056|22000000000000000000000000000000000000000010000222222222222000000000000001000000000000000000000000000000000000000000000000000022
057|22000000000000000000000000000000000000000010000222222222222000000000000001000000000000000000000000000000000000000000000000000022
058|22000000000000000000000000000001111111100011000000000000000000000000000001000000000000000000000000000000000000000000000000000022
059|22000000000000000000000000000001000000000000100000000000000000000000000001000000000000000000000000000000000000000000000000000022
05A|22000000000000000000000000000001000000000000010000000000000000000000000001000000000000000000000000000000000000000000000000000022
05B|22000000000000000000000000000001002222220010001000000000000000000000000001000000000000000000000000000000000000000000000000000022
05c|22000000000000000000000000000001002222220010000100000000000000000000000001000000000000000000000000000000000000000000000000000022
05d|22000000000000000000000000000001002222220010000010000000000000000000000001000000000000000000000000000000000000000000000000000022
05E|22000000000000000000000000000001002222220010000001002222222222222222220010000000000000000000000000000000000000000000000000000022
05F|22000000000000000000000000000001002222220010000000100222222222222222200100000000000000000000000000000000000000000000000000000022
060|22000000000000000000000000000001002222220010000000010022222222222222001000000000000000000000000000000000000000000000000000000022
061|22000000000000000000000000000001000000000010000000001000000000000000010000000000000000000000000000000000000000000000000000000022
062|22000000000000000000000000000001000000000010000000000100000000000000100000000000000000000000000000000000000000000000000000000022
063|22000000000000000000000000000001111111111111111111110011111111111111000000000000000000000000000000000000000000000000000000000022
064|22000000000000000000000000000000000000000000000000000000000000000000000000000000000000000000000000000000000000000000000000000022
065|22000000000000000000000000000000000000000000000000000000000000000000000000000000000000000000000000000000000000000000000000000022
066|22000000000000000000000000000000000000000002222222222222222222222222222220000000000000000000000000000000000000000000000000000022
067|22000000000000000000000000000000000002222222221111111111111112222222222222222220000000000000000000000000000000000000000000000022
068|22000000000000000000000000000000000002222222222222222222222222222222222222222220000000000000000000000000000000000000000000000022
069|22000000000000000000000000000000000000000000000000000000000000000000000000000000000000000000000000000000000000000000000000000022
06A|22000000000000000000000000000000000000000000000000000000000000000000000000000000000000000000000000000000000000000000000000000022
06B|22000000000000000000000000000000000000000000000000000000000000000000000000000000000000000000000000000000000000000000000000000022
06C|22000000000000000000000000000000000000000000000000000000000000000000000000000000000000000000000000000000000000000000000000000022
06D|22000000000000000000000000000000000000000000000000000000000000000000000000000000000000000000000000000000000000000000000000000022
06E|22000000000000000000000000000000000000000000000000000000000000000000000000000000000000000000000000000000000000000000000000000022
06F|22000000000000000000000000000000000000000000000000000000000000000000000000000000000000000000000000000000000000000000000000000022
070|22000000000000000000000000000000000000000000000000000000000000000000000000000000000000000000000000000000000000000000000000000022
071|22000000000000000000000000000000000000000000000000000000000000000000000000000000000000000000000000000000000000000000000000000022
072|22000000000000000000000000000000000000000000000000000000000000000000000000000000000000000000000000000000000000000000000000000022
073|22000000000000000000000000000000000000000000000000000000000000000000000000000000000000000000000000000000000000000000000000000022
074|22000000000000000000000000000000000000000000000000000000000000000000000000000000000000000000000000000000000000000000000000000022
075|22222222222222222222222222222222222222222222222222222222222222222222222222222222222222222222222222222222222222222222222222222222
076|22222222222222222222222222222222222222222222222222222222222222222222222222222222222222222222222222222222222222222222222222222222
077|22222222222222222222222222222222222222222222222222222222222222222222222222222222222222222222222222222222222222222222222222222222
078|22222222222222222222222222222222222222222222222222222222222222222222222222222222222222222222222222222222222222222222222222222222
079|22222222222222222222222222222222222222222222222222222222222222222222222222222222222222222222222222222222222222222222222222222222
07A|22222222222222222222222222222222222222222222222222222222222222222222222222222222222222222222222222222222222222222222222222222222
07B|22222222222222222222222222222222222222222222222222222222222222222222222222222222222222222222222222222222222222222222222222222222
07C|22222222222222222222222222222222222222222222222222222222222222222222222222222222222222222222222222222222222222222222222222222222
07D|22222222222222222222222222222222222222222222222222222222222222222222222222222222222222222222222222222222222222222222222222222222
07E|22222222222222222222222222222222222222222222222222222222222222222222222222222222222222222222222222222222222222222222222222222222
07F|22222222222222222222222222222222222222222222222222222222222222222222222222222222222222222222222222222222222222222222222222222222
